R      	1600 900
NO      ./textures/yellow_stone.xpm
SO      ./textures/wall1.xpm
WE      ./textures/wood.xpm
EA         ./textures/wall2.xpm
S ./textures/jojohires.xpm


    C 194, 131, 140

F     232, 212, 158
111
101   111
101111111
100020011
102000001
100002001
100000N01
100000001
111111111
		
		 	
