R      	1600 900
NO      ./textures/yellow_stone.xpm
SO      ./textures/wall1.xpm
WE      ./textures/wood.xpm
EA         ./textures/wall2.xpm
S ./textures/jojohires.xpm
C 194, 131, 140

F     232, 212, 158
                                    11      11
                   1111             111    111             11111
              111111021             1221111221             11000111
           111000002001            11000000001             110000111111
         11000000200001            110000000011            11100000000011
       11000000000000001         111000000000111         111100000000000111
     110000000000000000111111111110000000000000111111111111111101111111111111
    10000000000000000000002111100000000000000000000000000000000000000000000001
   100000000000000000000000211100000000000000000001110000000000000000000000001
   10000000000000000000000211110000000000N0000000022122000000000000000000000001
   1000000000000000000000000000000000000000000000022122000000000000000000000001
   100000000000000000000000000000000000000000000001112000000000000000000000001
    10000000000000011000000000010000000000000000001222000000110000000000000001
     10000000000111  1111111111 111000000000001111 111111111  111100000000011
      1110000001          11       11000000011       111         1000000011
        11111211                     1100001                     12221111
           111111                      1111                      11111
                11                      11                      11
