R      	1600 900
NO      ./textures/yellow_stone.xpm
SO      ./textures/wall1.xpm
WE      ./textures/wood.xpm
EA         ./textures/wall2.xpm
S ./textures/jojohires.xpm
C 194, 131, 140

F     232, 212, 158
                        1           111111111           1
                        11        1100000000011        11
                        11     1111000000000001111     11
                        11   11000000000000000000011   11
                        101  1000000000000000000001   101
                        101   100000000000000000001   101
                       1001  10000000000000000000001 10001
                      1000111000000000000000000000001100001
                     100000000000000000000000000000000000001
                   110000000000000000000000000000000000000001
                   1000000000000000000000000000000000000000001
                    10000011000000000000000000000000010000001
                    1000001 1000000000000000000000001 1000001
                     100000111100000000000000000001111000001
                      11110001 110000000N000000011 10001111
                          1101   100000000000001   10111
                            111   1011120211101   111
                             11   1011120211101  11
                                  1011120211101
                                 110111222111011
                                 111111111111111
                                 111         111
                                  11          11
                                   1          1
